1111111111111111111111111111111111
1000000E00000000000000000000000CP1
1000000000000000000000000000000C01
1000000000000000000000000000000C01
1000000000000000000000000000000C01
1111111111111111111111111111111111